"username","comments","upvotes","downvotes","commentscore","score.per.comment","votes","proposals"
"bee",132,636,25,232,1.76,661,0
"jy-p",56,126,35,229,4.09,161,3
"richard-red",53,170,8,183,3.45,178,5
"ryanzim",50,108,42,167,3.34,150,0
"s_ben",40,107,0,107,2.67,107,0
"degeri",39,71,12,101,2.59,83,2
"nnnko56",21,14,12,100,4.76,26,0
"jz_bz",13,45,2,86,6.62,47,0
"oregonisaac",25,32,3,85,3.4,35,2
"dz_",25,88,18,83,3.32,106,0
"davecgh",14,5,0,79,5.64,5,1
"praxis",13,67,11,72,5.54,78,0
"dustorf",16,21,5,44,2.75,26,2
"fiach.dubh",12,36,0,43,3.58,36,0
"blainr",19,0,0,42,2.21,0,1
"lizbagot",13,0,0,42,3.23,0,1
"karamble",15,13,1,40,2.67,14,1
"guang",8,2,0,37,4.62,2,0
"sambiohazard",21,38,3,35,1.67,41,0
"david",6,64,3,31,5.17,67,0
"linnutee",9,13,1,31,3.44,14,0
"politicon",38,67,9,30,0.79,76,0
"gravityz3r0",7,3,3,30,4.29,6,0
"matheusd",6,12,1,29,4.83,13,0
"haon",9,7,0,27,3,7,0
"jer979",29,0,0,26,0.9,0,1
"dennilovejoy",20,2,0,24,1.2,2,1
"tomcurranlevett",30,6,2,23,0.77,8,1
"nottrunner",8,13,1,22,2.75,14,0
"ftl_ian",11,0,0,22,2,0,1
"ski",7,12,2,21,3,14,0
"moo31337",8,1,0,17,2.12,1,1
"ay-p",2,22,22,16,8,44,0
"jholdstock",4,4,0,15,3.75,4,0
"pubpete",6,12,0,15,2.5,12,0
"decrenator",17,26,5,14,0.82,31,0
"audi",4,10,1,14,3.5,11,0
"solar",3,13,5,14,4.67,18,0
"a_f",10,36,13,13,1.3,49,0
"betterfuture",12,6,2,13,1.08,8,1
"vadymprykhodko",4,0,0,13,3.25,0,1
"somebody_online",9,58,3,12,1.33,61,0
"kozel",12,13,0,12,1,13,0
"dcrtrader",8,6,0,12,1.5,6,0
"medge2",7,10,6,12,1.71,16,0
"victorone",5,22,0,11,2.2,22,0
"xiaozhu1717",19,0,0,11,0.58,0,0
"lukebp",3,12,0,10,3.33,12,0
"luis",4,3,1,9,2.25,4,0
"chappjc",5,23,0,9,1.8,23,0
"dcredits77",3,1,0,9,3,1,0
"dcrsov",2,0,0,9,4.5,0,0
"lolekbolek",2,0,0,9,4.5,0,0
"purplesuede22",2,13,0,8,4,13,0
"dpr",5,16,0,8,1.6,16,0
"exitus",3,3,0,8,2.67,3,0
"mark_ftl",7,35,11,7,1,46,0
"narutosasuke",8,1,0,7,0.88,1,0
"amnash002",1,1,0,6,6,1,0
"zubairzia0",2,20,3,6,3,23,0
"dnldd",2,8,0,6,3,8,0
"vladstan",3,3,1,6,2,4,0
"john",2,14,3,6,3,17,0
"dre-tech",2,7,0,6,3,7,0
"snr01",2,0,0,6,3,0,0
"shaun",2,1,0,6,3,1,0
"amtowghng",6,16,0,6,1,16,0
"changhugo",4,13,5,6,1.5,18,0
"vjv",1,4,1,6,6,5,0
"georgepro",19,6,0,6,0.32,6,1
"fort3hlulz",2,7,0,5,2.5,7,0
"searvo",5,1,0,5,1,1,0
"jerseypotato",3,29,4,5,1.67,33,0
"teknico",2,69,67,5,2.5,136,0
"dezryth",2,0,0,5,2.5,0,0
"neil_nie",2,6,0,5,2.5,6,0
"johnnyk",6,14,4,5,0.83,18,0
"thedecreddigest",1,3,0,5,5,3,0
"parallelind",7,8,0,5,0.71,8,0
"jzzh",1,0,0,5,5,0,0
"acean",11,0,0,5,0.45,0,1
"nickb",1,1,0,5,5,1,0
"tiagoad",1,3,1,4,4,4,0
"applesaucesome",1,61,8,4,4,69,0
"sonvister",3,23,12,4,1.33,35,0
"commodore_scoobysnack",2,6,0,4,2,6,0
"odin",2,7,2,4,2,9,0
"ikarus477",1,1,0,4,4,1,0
"qcmrhyde",2,1,0,4,2,1,0
"yellop",1,5,0,4,4,5,0
"michae2xl",3,14,0,3,1,14,0
"gozart",1,0,0,3,3,0,0
"bfriel",1,10,0,3,3,10,0
"cryptoeconomy",3,0,0,3,1,0,1
"mission",2,19,1,3,1.5,20,0
"adam2312",1,4,0,3,3,4,0
"raedah",1,0,0,3,3,0,0
"lewildbeast",5,3,0,3,0.6,3,0
"amphetamine",8,16,3,3,0.38,19,0
"stakeynet",5,20,0,3,0.6,20,0
"hashfunction8",1,0,1,3,3,1,1
"francio",3,0,0,3,1,0,1
"hubertin",1,31,0,3,3,31,0
"esperantomato",1,8,1,3,3,9,0
"rickshaw",1,0,0,3,3,0,0
"peterparker503",2,0,0,3,1.5,0,0
"santasnotreal",1,56,1,2,2,57,0
"scarmani",1,4,0,2,2,4,0
"_checkmate_",2,0,0,2,1,0,1
"sumiflow",1,6,0,2,2,6,0
"bcashgr",15,0,0,2,0.13,0,1
"rzs",1,5,0,2,2,5,0
"cagochi",1,37,0,1,1,37,0
"clwys",1,0,0,1,1,0,0
"thu",1,1,0,1,1,1,0
"aronb",1,5,1,1,1,6,0
"bliv",1,3,0,1,1,3,0
"rramires",2,3,0,1,0.5,3,0
"sammysunshine",1,4,1,1,1,5,0
"ggeorgiev",1,0,0,1,1,0,0
"oiez",0,100,9,0,NA,109,0
"vvesi",0,8,0,0,NA,8,0
"test",1,1,1,0,0,2,0
"kandiru",0,15,0,0,NA,15,0
"sl1200mk5",0,39,0,0,NA,39,0
"jpm",0,8,1,0,NA,9,0
"issedjur",0,19,4,0,NA,23,0
"sndurkin",0,0,1,0,NA,1,0
"oxf",0,4,0,0,NA,4,0
"politeia_user",0,30,2,0,NA,32,0
"pedroabreu",0,2,0,0,NA,2,0
"orbital",0,3,0,0,NA,3,0
"ardberg",0,1,1,0,NA,2,0
"rstaudt2",0,6,0,0,NA,6,0
"mvz1keon7zwkcob",0,2,0,0,NA,2,0
"jiecut",0,3,1,0,NA,4,0
"life",1,0,0,0,0,0,0
"vanjan",0,1,0,0,NA,1,0
"evan",0,1,1,0,NA,2,0
"dominicting",2,0,0,0,0,0,0
"jzsantoro",0,1,0,0,NA,1,0
"lhb",0,5,0,0,NA,5,0
"joesri",0,3,2,0,NA,5,0
"nahc",1,2,1,0,0,3,0
"timhebel",0,1,0,0,NA,1,0
"gaurav_blocknext",0,1,1,0,NA,2,0
"carlosccp",0,1,1,0,NA,2,0
"knaq",0,2,0,0,NA,2,0
"lustrousgorilla",1,0,0,0,0,0,0
"jsterling8",4,7,1,-1,-0.25,8,0
"sikas",3,19,1,-2,-0.67,20,0
"burst",6,12,4,-5,-0.83,16,1
"limited",21,0,0,-5,-0.24,0,1
"alexis",29,34,21,-48,-1.66,55,0
